{
    "TerrainName": "Custom Shoals",
    "Size": {
        "X": 19,
        "Y": 25
    },
    "Ids": [
        45,28,28,28,28,37,28,28,33,28,28,30,34,1,26,26,30,29,28,
        102,108,28,28,30,30,30,30,28,28,30,30,1,34,26,26,30,44,29,
        33,28,28,30,1,1,30,30,30,30,1,30,30,3,28,28,37,30,30,
        28,33,30,30,44,1,34,30,30,3,34,1,30,30,30,28,28,27,27,
        28,28,34,3,30,2,3,30,28,30,1,34,30,28,30,30,3,1,16,
        30,28,28,30,34,30,30,28,30,30,30,1,3,1,34,30,1,34,16,
        34,28,33,28,28,28,28,30,30,30,28,1,30,29,1,28,29,28,16,
        1,29,28,28,140,30,30,3,30,34,1,3,2,30,30,30,30,1,16,
        1,3,28,1,1,30,18,19,28,30,30,30,28,34,1,1,18,15,20,
        34,30,28,30,29,3,21,133,19,30,1,29,28,30,3,2,16,3,34,
        30,28,3,29,32,1,1,21,20,30,3,1,33,30,1,30,37,30,1,
        29,29,34,28,1,34,1,28,30,29,1,34,30,3,34,30,16,30,28,
        28,33,16,29,29,30,30,30,1,145,1,30,30,30,30,30,16,33,28,
        28,30,16,30,34,3,29,34,1,32,30,28,1,34,1,28,34,30,30,
        1,30,37,30,1,29,33,1,3,30,18,19,1,1,31,30,3,28,30,
        34,3,16,2,3,29,28,30,1,30,21,133,19,3,30,29,28,30,34,
        18,15,20,1,1,34,28,30,29,30,28,21,20,30,1,1,28,3,1,
        16,1,30,30,30,29,2,3,1,34,29,3,30,29,146,28,28,30,1,
        16,28,30,28,1,30,30,1,28,30,30,30,28,28,28,28,33,28,34,
        16,34,1,30,34,1,3,1,30,30,30,28,30,30,34,30,28,28,30,
        16,1,3,30,30,28,30,34,1,30,28,30,3,2,30,3,34,28,28,
        27,27,28,28,30,30,30,1,34,3,30,30,34,1,39,30,30,33,28,
        30,30,37,28,28,3,30,30,1,30,30,30,30,1,1,29,28,28,33,
        30,39,30,26,26,34,1,30,30,28,28,30,30,30,29,28,28,110,102,
        28,30,30,26,26,1,34,30,28,28,33,28,28,37,28,28,28,28,40
    ]
}