{
    "TerrainName": "Sea Test",
    "Size": {
        "X": 36,
        "Y": 36
    },
    "Ids": [
        1,1,1,1,1,28,1,1,1,1,1,28,1,1,1,1,1,28,1,1,1,1,1,28,1,1,1,1,1,28,1,1,1,1,1,28,
        1,1,1,1,1,28,1,1,28,1,1,28,1,1,1,1,1,28,1,1,1,1,1,28,1,1,1,1,1,28,1,1,28,1,1,28,
        1,1,28,1,1,28,1,1,28,1,1,28,1,1,28,28,1,28,1,1,28,1,1,28,1,28,28,1,1,28,1,1,28,1,1,28,
        1,1,1,1,1,28,1,1,1,1,1,28,1,1,1,1,1,28,1,1,28,1,1,28,1,1,1,1,1,28,1,1,28,1,1,28,
        1,1,1,1,1,28,1,1,1,1,1,28,1,1,1,1,1,28,1,1,1,1,1,28,1,1,1,1,1,28,1,1,1,1,1,28,
        28,28,28,28,28,28,28,28,28,28,28,28,28,28,28,28,28,28,28,28,28,28,28,28,28,28,28,28,28,28,28,28,28,28,28,28,
        1,1,1,1,1,28,1,1,1,1,1,28,1,1,1,1,1,28,1,1,1,1,1,28,1,1,1,1,1,28,1,1,1,1,1,28,
        1,1,1,1,1,28,1,1,28,1,1,28,1,28,28,1,1,28,1,1,28,1,1,28,1,1,28,28,1,28,1,1,1,1,1,28,
        1,28,28,28,1,28,1,28,28,1,1,28,1,28,28,1,1,28,1,1,28,28,1,28,1,1,28,28,1,28,1,1,28,28,1,28,
        1,1,1,1,1,28,1,1,1,1,1,28,1,1,1,1,1,28,1,1,1,1,1,28,1,1,1,1,1,28,1,1,28,1,1,28,
        1,1,1,1,1,28,1,1,1,1,1,28,1,1,1,1,1,28,1,1,1,1,1,28,1,1,1,1,1,28,1,1,1,1,1,28,
        28,28,28,28,28,28,28,28,28,28,28,28,28,28,28,28,28,28,28,28,28,28,28,28,28,28,28,28,28,28,28,28,28,28,28,28,
        1,1,1,1,1,28,1,1,1,1,1,28,1,1,1,1,1,28,1,1,1,1,1,28,1,1,1,1,1,28,1,1,1,1,1,28,
        1,1,1,1,1,28,1,1,1,1,1,28,1,1,1,1,1,28,1,1,1,1,1,28,1,1,1,1,1,28,1,1,1,1,1,28,
        1,1,28,28,1,28,1,28,28,1,1,28,1,28,28,1,1,28,1,28,28,28,1,28,1,28,28,28,1,28,1,28,28,28,1,28,
        1,1,28,28,1,28,1,1,28,1,1,28,1,28,28,1,1,28,1,1,28,1,1,28,1,1,28,28,1,28,1,28,28,1,1,28,
        1,1,1,1,1,28,1,1,1,1,1,28,1,1,1,1,1,28,1,1,1,1,1,28,1,1,1,1,1,28,1,1,1,1,1,28,
        28,28,28,28,28,28,28,28,28,28,28,28,28,28,28,28,28,28,28,28,28,28,28,28,28,28,28,28,28,28,28,28,28,28,28,28,
        1,1,1,1,1,28,1,1,1,1,1,28,1,1,1,1,1,28,1,1,1,1,1,28,1,1,1,1,1,28,1,1,1,1,1,28,
        1,1,1,1,1,28,1,1,28,1,1,28,1,1,28,1,1,28,1,28,28,1,1,28,1,28,28,1,1,28,1,1,28,1,1,28,
        1,28,28,28,1,28,1,28,28,1,1,28,1,28,28,1,1,28,1,28,28,1,1,28,1,28,28,1,1,28,1,28,28,28,1,28,
        1,28,28,28,1,28,1,1,28,1,1,28,1,28,28,1,1,28,1,1,28,1,1,28,1,28,28,1,1,28,1,1,1,1,1,28,
        1,1,1,1,1,28,1,1,1,1,1,28,1,1,1,1,1,28,1,1,1,1,1,28,1,1,1,1,1,28,1,1,1,1,1,28,
        28,28,28,28,28,28,28,28,28,28,28,28,28,28,28,28,28,28,28,28,28,28,28,28,28,28,28,28,28,28,28,28,28,28,28,28,
        1,1,1,1,1,28,1,1,1,1,1,28,1,1,1,1,1,28,1,1,1,1,1,28,1,1,1,1,1,28,1,1,1,1,1,28,
        1,1,28,28,1,28,1,28,28,1,1,28,1,28,28,28,1,28,1,1,28,1,1,28,1,1,28,1,1,28,1,1,28,28,1,28,
        1,28,28,28,1,28,1,28,28,28,1,28,1,28,28,28,1,28,1,1,28,28,1,28,1,1,28,28,1,28,1,1,28,28,1,28,
        1,1,1,1,1,28,1,1,1,1,1,28,1,1,1,1,1,28,1,1,28,1,1,28,1,1,28,28,1,28,1,1,28,1,1,28,
        1,1,1,1,1,28,1,1,1,1,1,28,1,1,1,1,1,28,1,1,1,1,1,28,1,1,1,1,1,28,1,1,1,1,1,28,
        28,28,28,28,28,28,28,28,28,28,28,28,28,28,28,28,28,28,28,28,28,28,28,28,28,28,28,28,28,28,28,28,28,28,28,28,
        1,1,1,1,1,28,1,28,1,28,1,28,1,28,1,28,1,28,28,28,1,28,1,28,28,28,1,28,28,28,28,28,1,28,28,28,
        1,1,28,28,1,28,28,28,28,28,28,28,28,28,28,28,28,28,28,28,28,28,28,28,28,28,28,28,28,28,28,28,28,28,1,28,
        1,1,28,28,1,28,1,28,1,28,1,28,28,28,28,28,1,28,1,28,1,28,1,28,1,28,28,28,1,28,1,28,28,28,28,28,
        1,1,28,28,1,28,28,28,28,28,28,28,28,28,28,28,28,28,28,28,28,28,28,28,28,28,28,28,28,28,28,28,28,28,1,28,
        1,1,1,1,1,28,28,28,28,28,28,28,28,1,28,28,28,28,28,28,28,28,28,28,28,1,28,1,28,28,28,28,28,28,28,28,
        28,28,28,28,28,28,28,28,28,28,28,28,28,28,28,28,28,28,28,28,28,28,28,28,28,28,28,28,28,28,28,28,28,28,28,28
    ]
}