{
    "TerrainName": "Shoal Alt Test B",
    "Size": {
        "X": 20,
        "Y": 20
    },
    "Ids": [
        28,1,1,28,1,1,28,1,1,28,1,1,28,28,28,28,28,28,28,28,
        28,1,29,28,1,29,29,1,29,28,1,29,29,28,28,1,30,1,28,28,
        28,28,28,28,28,28,28,28,29,28,28,29,28,28,28,28,28,28,28,28,
        28,1,1,28,1,1,28,1,1,28,1,1,28,28,28,1,30,1,28,28,
        28,29,1,29,29,1,28,29,1,29,29,1,28,28,28,28,30,28,28,28,
        28,28,28,28,28,28,28,29,28,28,29,28,28,28,28,1,30,1,28,28,
        28,29,1,29,29,1,28,29,1,29,29,1,28,28,28,28,28,28,28,28,
        28,1,1,28,1,1,28,1,1,28,1,1,28,28,1,28,1,28,1,28,
        28,28,28,28,28,29,28,28,28,28,28,29,28,28,29,29,29,28,29,28,
        28,1,29,28,1,29,28,1,29,29,1,29,29,28,1,28,1,28,1,28,
        28,1,1,28,1,1,28,1,1,28,1,1,28,28,28,28,28,28,28,28,
        28,28,28,28,28,28,28,28,28,28,28,28,28,28,28,28,29,28,28,28,
        1,1,1,28,1,1,1,28,1,1,28,1,1,28,28,1,29,1,28,28,
        1,29,1,28,1,29,1,28,1,29,28,29,1,28,28,28,29,28,28,28,
        28,28,28,28,28,29,28,28,1,1,28,1,1,28,28,28,28,28,28,28,
        1,29,1,28,1,29,1,28,28,28,28,28,28,28,28,28,1,28,28,28,
        1,1,1,28,1,1,1,28,1,1,28,1,1,28,28,29,29,29,28,28,
        28,28,28,28,28,28,28,28,1,29,29,29,1,28,28,28,1,28,28,28,
        28,28,28,28,28,28,28,28,1,1,28,1,1,28,28,28,28,28,28,28,
        28,28,28,28,28,28,28,28,28,28,28,28,28,28,28,28,28,28,28,28
    ]
}