{
    "TerrainName": "Shoal Alt Test A",
    "Size": {
        "X": 20,
        "Y": 20
    },
    "Ids": [
        28,28,28,28,28,28,28,28,28,28,28,28,28,28,28,28,28,28,28,28,
        28,28,28,28,28,28,28,28,28,28,28,28,28,28,28,28,28,28,28,28,
        28,28,28,28,30,30,30,28,28,28,28,28,28,28,28,28,28,28,28,28,
        28,28,28,31,1,1,1,32,28,28,28,28,28,28,28,30,28,28,28,28,
        28,28,28,31,1,1,1,32,28,28,28,28,28,28,31,1,32,28,28,28,
        28,28,28,31,1,1,1,32,28,28,28,28,28,28,28,29,28,28,28,28,
        28,28,28,28,29,29,29,28,28,28,28,28,28,28,28,28,28,28,28,28,
        28,28,28,28,28,28,28,28,28,28,28,28,28,28,28,28,28,28,28,28,
        28,28,28,28,28,28,28,28,28,28,28,28,28,28,28,28,28,28,28,28,
        28,28,28,28,28,28,28,28,30,28,28,30,30,30,28,28,28,28,28,28,
        28,28,28,28,28,28,28,28,28,28,28,28,28,28,28,28,28,28,28,28,
        28,28,28,28,28,28,28,28,28,28,28,28,28,28,28,28,28,28,28,28,
        28,28,28,28,28,28,28,28,31,28,28,28,28,28,29,29,29,28,28,28,
        28,28,28,28,28,28,28,28,31,28,28,28,28,28,30,30,30,28,28,28,
        28,28,28,29,28,28,28,28,31,28,28,28,32,31,1,1,1,32,31,28,
        28,28,28,30,28,28,28,28,28,28,28,28,32,31,1,1,1,32,31,28,
        28,32,31,1,32,31,28,28,28,28,28,28,32,31,1,1,1,32,31,28,
        28,28,28,29,28,28,28,28,28,28,28,28,28,28,29,29,29,28,28,28,
        28,28,28,30,28,28,28,28,28,28,28,28,28,28,30,30,30,28,28,28,
        28,28,28,28,28,28,28,28,28,28,28,28,28,28,28,28,28,28,28,28
    ]
}