{
    "TerrainName": "Sea Test",
    "Size": {
        "X": 36,
        "Y": 36
    },
    "Ids": [
        1,1,1,1,1,29,1,1,1,1,1,29,1,1,1,1,1,29,1,1,1,1,1,29,1,1,1,1,1,29,1,1,1,1,1,29,
        1,1,1,1,1,29,1,1,29,1,1,29,1,1,1,1,1,29,1,1,1,1,1,29,1,1,1,1,1,29,1,1,29,1,1,29,
        1,1,29,1,1,29,1,1,29,1,1,29,1,1,29,29,1,29,1,1,29,1,1,29,1,29,29,1,1,29,1,1,29,1,1,29,
        1,1,1,1,1,29,1,1,1,1,1,29,1,1,1,1,1,29,1,1,29,1,1,29,1,1,1,1,1,29,1,1,29,1,1,29,
        1,1,1,1,1,29,1,1,1,1,1,29,1,1,1,1,1,29,1,1,1,1,1,29,1,1,1,1,1,29,1,1,1,1,1,29,
        29,29,29,29,29,29,29,29,29,29,29,29,29,29,29,29,29,29,29,29,29,29,29,29,29,29,29,29,29,29,29,29,29,29,29,29,
        1,1,1,1,1,29,1,1,1,1,1,29,1,1,1,1,1,29,1,1,1,1,1,29,1,1,1,1,1,29,1,1,1,1,1,29,
        1,1,1,1,1,29,1,1,29,1,1,29,1,29,29,1,1,29,1,1,29,1,1,29,1,1,29,29,1,29,1,1,1,1,1,29,
        1,29,29,29,1,29,1,29,29,1,1,29,1,29,29,1,1,29,1,1,29,29,1,29,1,1,29,29,1,29,1,1,29,29,1,29,
        1,1,1,1,1,29,1,1,1,1,1,29,1,1,1,1,1,29,1,1,1,1,1,29,1,1,1,1,1,29,1,1,29,1,1,29,
        1,1,1,1,1,29,1,1,1,1,1,29,1,1,1,1,1,29,1,1,1,1,1,29,1,1,1,1,1,29,1,1,1,1,1,29,
        29,29,29,29,29,29,29,29,29,29,29,29,29,29,29,29,29,29,29,29,29,29,29,29,29,29,29,29,29,29,29,29,29,29,29,29,
        1,1,1,1,1,29,1,1,1,1,1,29,1,1,1,1,1,29,1,1,1,1,1,29,1,1,1,1,1,29,1,1,1,1,1,29,
        1,1,1,1,1,29,1,1,1,1,1,29,1,1,1,1,1,29,1,1,1,1,1,29,1,1,1,1,1,29,1,1,1,1,1,29,
        1,1,29,29,1,29,1,29,29,1,1,29,1,29,29,1,1,29,1,29,29,29,1,29,1,29,29,29,1,29,1,29,29,29,1,29,
        1,1,29,29,1,29,1,1,29,1,1,29,1,29,29,1,1,29,1,1,29,1,1,29,1,1,29,29,1,29,1,29,29,1,1,29,
        1,1,1,1,1,29,1,1,1,1,1,29,1,1,1,1,1,29,1,1,1,1,1,29,1,1,1,1,1,29,1,1,1,1,1,29,
        29,29,29,29,29,29,29,29,29,29,29,29,29,29,29,29,29,29,29,29,29,29,29,29,29,29,29,29,29,29,29,29,29,29,29,29,
        1,1,1,1,1,29,1,1,1,1,1,29,1,1,1,1,1,29,1,1,1,1,1,29,1,1,1,1,1,29,1,1,1,1,1,29,
        1,1,1,1,1,29,1,1,29,1,1,29,1,1,29,1,1,29,1,29,29,1,1,29,1,29,29,1,1,29,1,1,29,1,1,29,
        1,29,29,29,1,29,1,29,29,1,1,29,1,29,29,1,1,29,1,29,29,1,1,29,1,29,29,1,1,29,1,29,29,29,1,29,
        1,29,29,29,1,29,1,1,29,1,1,29,1,29,29,1,1,29,1,1,29,1,1,29,1,29,29,1,1,29,1,1,1,1,1,29,
        1,1,1,1,1,29,1,1,1,1,1,29,1,1,1,1,1,29,1,1,1,1,1,29,1,1,1,1,1,29,1,1,1,1,1,29,
        29,29,29,29,29,29,29,29,29,29,29,29,29,29,29,29,29,29,29,29,29,29,29,29,29,29,29,29,29,29,29,29,29,29,29,29,
        1,1,1,1,1,29,1,1,1,1,1,29,1,1,1,1,1,29,1,1,1,1,1,29,1,1,1,1,1,29,1,1,1,1,1,29,
        1,1,29,29,1,29,1,29,29,1,1,29,1,29,29,29,1,29,1,1,29,1,1,29,1,1,29,1,1,29,1,1,29,29,1,29,
        1,29,29,29,1,29,1,29,29,29,1,29,1,29,29,29,1,29,1,1,29,29,1,29,1,1,29,29,1,29,1,1,29,29,1,29,
        1,1,1,1,1,29,1,1,1,1,1,29,1,1,1,1,1,29,1,1,29,1,1,29,1,1,29,29,1,29,1,1,29,1,1,29,
        1,1,1,1,1,29,1,1,1,1,1,29,1,1,1,1,1,29,1,1,1,1,1,29,1,1,1,1,1,29,1,1,1,1,1,29,
        29,29,29,29,29,29,29,29,29,29,29,29,29,29,29,29,29,29,29,29,29,29,29,29,29,29,29,29,29,29,29,29,29,29,29,29,
        1,1,1,1,1,29,1,29,1,29,1,29,1,29,1,29,1,29,29,29,1,29,1,29,29,29,1,29,29,29,29,29,1,29,29,29,
        1,1,29,29,1,29,29,29,29,29,29,29,29,29,29,29,29,29,29,29,29,29,29,29,29,29,29,29,29,29,29,29,29,29,1,29,
        1,1,29,29,1,29,1,29,1,29,1,29,29,29,29,29,1,29,1,29,1,29,1,29,1,29,29,29,1,29,1,29,29,29,29,29,
        1,1,29,29,1,29,29,29,29,29,29,29,29,29,29,29,29,29,29,29,29,29,29,29,29,29,29,29,29,29,29,29,29,29,1,29,
        1,1,1,1,1,29,29,29,29,29,29,29,29,1,29,29,29,29,29,29,29,29,29,29,29,1,29,1,29,29,29,29,29,29,29,29,
        29,29,29,29,29,29,29,29,29,29,29,29,29,29,29,29,29,29,29,29,29,29,29,29,29,29,29,29,29,29,29,29,29,29,29,29
    ]
}